* ***********************
*                        
* ******************* ***
* ******************* ***
* ******************* ***
* ******************* ***
* ******************* ***
*                        
* ***********************
* ***********************
* ***********************
* ***********************
*                        
* ******************* ***
* ******************* ***
* ******************* ***
* ******************* ***
* ******************* ***
*                        
* ***********************
* ***********************
* ***********************
*                        
*************************
*************************
