* **** ****** ***********
*    * *    * *   *     *
* ** *   ** * * *** * * *
* *  * * * ** *     * * *
  **** *      * ***** * *
*       *******    ** * *
* *****         **  * * *
*  *    *** * * ***** * *
** * ****** * ** *  * * *
   *      * * ** ** * * *
 ******** * *  *      * *
 *  *  *  * **** ****** *
 ** ** **** ***  *      *
    **        * *********
****** ** ***** *       *
       **     * * ***** *
 *****   * ** * * *   * *
 **   **** ** *   * *   *
 *  *    * *  * *** *****
 ** * **** ** *   *   *  
    * *    ** * * *** * *
 **** **** ** * *   * * *
 *    *  * **** *** * * *
 ****** **  *   *   *   *
        ************** **